Giorgos	Galani
Maria	Generator
Dimitris	Voulgaris
Eleni	Oikonomidou
Giannis	Damaskini
Sofia	Hatzinikolaou
Kostas	Isidora
Anna	Anastasios
Panagiotis	Cherry
Katerina	Karsivanis
Nikos	Spyropoulos
Eva	Papastephanou
Andreas	Painter
Irene	boy
Stavros	Hatziioannou
Niki	Stavroula
Alexandros	Ioannis
Despoina	Makri
Christos	Dawn
Foteini	Alexandrou
Marios	Anifanti
Konstantina	Reverend
Spiros	Xanthopoulos
Athina	Krystallis
Lazaros	Laskarou
Elpida	Ragos
Vasilis	Xanthopoulou
Dimitra	Daskalopoulos
Thomas	Konstantinou
Ioanna	Pantazis
Petros	Xenos
Melina	Papaioannou
Manos	Varibompi
Rania	Papastephanos
Haris	Konstantinidou